####################################################################################################
####..[]......................##....[]......[]..[]........[][]............[][]......[]..[]....##..##
##[][][]......[][]..##[]......##....[][]..[]..........[]....####[]......[]........[]........[]....##
####........[]......[]..................[][]##......[]..[]##..##[]..[]..........##................##
##[][]..[][]..[]..[][]..##..[]....[]..[]##..[]......[][]....[]....[]##..[][][]......[]........[]..##
##[]......[]..[]....[]........[]......[][]....##......[]..##[]......[][]............[]....##..[]..##
##....[]..............[][]....####..##..[]..[]..[]..........##......[][]....[]........[]....[]..[]##
##..[]........[][]..[]##..##[]..[]................[]..##............[]....####[]....[]........[]..##
##[]..........[]....[]..[]..[]......##............[]..[]..[]......[]##..........[]##..##....[]..####
##..............[]....##........##........[]........[]....####[]..............##..........[]......##
##..........##......[][]..[]......[]........[]....[]##..................[]....[]..[]..[]..........##
##[]..............[]..............[]....[]..[]........##..[]....................[]......##......[]##
##..[][][][][][]##......[]##......##........[]......##..####......##....[]..[][]##[][][][]##......##
##....[]........[]..[][][][]..[]..##............[]..####......##..##[]......[]........[]..[]..[][]##
####[][][][]######....[]....[]..[]..................##......[]##..[]....[]..[][]....####....[][]..##
##............[][][]..........[]........[]......[]..##....[]......[][]......[][]..[]......##[]....##
##............[][]......##[]##......[][][]..................[]................[]..........[][]....##
##..##......[]..[]........##..............[][][]......[]......[]##..[][]....##..##..[]....[]......##
##[][]..[]......[]..[]..##........[][]....##..[]..[]..............####[]....[]..[]....[]..........##
####..[]##[][][]..........[]..........##..........[]##....[][]......[]....[]....[]..........[]....##
##......[]..[]....[]....[]..[]..........[]..[][]..........[]......[]......##....[]..........[]..[]##
##[]....[][]..[]..##....[]....[]........[][][]..[]..[]..........................[][]........[]..[]##
##..[][]##[]..[]..[]..[][][][]##[]......[]..##..[]........##................[]..[]....##......##[]##
##[]..[]..##[]....##......[][][][]....................[]......##[][][]........##[]....##[]....[]..##
##....[]..[][]............##......[][]....[]..[]@.[]##..##..........[]..........##..##[][]..##....##
##[]....[]..........[][][]........[]......##....##........[]....##[][][][]................[]......##
##[]....[]##..##....[]..........[]..[]..........[][][]....[]....[]..##....##[][]..........[]..[]####
##....................[]........[]......[]..##............[]....[]..............[]................##
##..[][]##............[]....[][]......##[]..[]..##..[]....[]..[]....................[][]........####
##....[]##[]..[]........[]##......[]..[]..[]..[]..[]....[]..[]..####[]..##....[]..[]..[]..##[]....##
##....[][][]..[]..[]......##..[]..[]..............[]......##[][]....[][]..######....##[]##....[]####
##..##[][][]..........##....[]........[][]..[]....##[]..[][]....##[]##..[]..##..[][]..............##
##..................[][][]..[][]..........##..........##[]..[]..[][][]......##[]......[][]..##[]####
##......[]......[]............[]......[]##....[]##[]##....[]..[][]..[]....[]..[]......[]..[]..[]..##
##..[]..........[][]......[][][]..[][]....[]............[][][]......[]##..........[]........[]....##
##[]....[]..............[]................[]......[]..[][][]..[]....##....[]......[]..[][]....[]..##
##......[]....##[]..[]............##....[]..............[][]..##....##[]....##[]..[]....##..[][]..##
##....[][]........##..........[][]..[]##........[]..[]##..[]......[]......[]....##....##..[][]..[]##
##......[][]..[]................[]......[]..[]............[]..[]..........................##[][]..##
##..........##[][]............[]##....[]##[]........[][]##[]........[]##......[][]..##[][][]......##
##..........[]..[][]............[][]##......##[]............[][]##......................[]..##[]####
##..[][]..[]..[]..[][]........[]................##....................[]....................[]....##
##[]..[][]....[]..[]....[][]......[]......[]..[][]....[]..........##....##..[][]..[][]..[][]..[][]##
##....[]....[]....[]..[]..##..........[]##....[]......##..........##......[]....[]........[]....####
##[]......##........[]..##........[]........[][]..[][]....[]....[]........##[]....[]..[]..[]..[]####
##....[]..............[]................[][]##..........[]..................##....................##
##......[]..##..[]..[][]##..............[]..##......[]..[]............[]..[]......................##
##..##..........[]............[]##..##..[]......[]##[]..[]..[]......[]..........[]....[]..[][]..####
##..........[]..[]....[]..............[]............[]....[]......[]##[]##..........[][][]........##
####################################################################################################
